портал  :  портал портал портал порталы портал портал портал портал портал портала порталы порталы портал портал портал портал портал портал портал портал портал портал портал
текущий  :  текущие текущие текущие текущие текущие текущие текущие текущие текущим текущие текущие текущие текущие текущие текущие текущие текущие текущие текущих текущие текущие
событие  :  события события события события события события события события события события события события события события события события события события событиям события события события события события события события событие события события события события события события события события события событиях события события
википедия  :  википедия википедия википедии википедия википедия википедии википедия википедия википедия википедии википедия википедия википедия википедии википедия википедии википедии википедии википедии википедии википедия википедии
январь  :  январь январь январь январь январь январь январь январь январь январь январь январь январь январь январь январь январь январь январь январь январь январь январь январь январь январь январь январь январь январь январь январь январь январь январь январь январь январь
февраль  :  февраль февраля февраля февраля февраль февраль февраля февраля февраля февраля февраля февраля февраля февраля февраля февраля февраля февраля февраля февраля февраля февраля февраля февраля февраля февраля февраля февраля февраля февраля февраля февраля февраля февраля февраль февраль февраль февраля февраля февраля февраля февраля февраля февраля февраля февраля февраля февраля февраля февраля февраля февраля февраля февраля февраля февраля февраля февраля февраля февраля февраля февраля февраля февраля февраля февраля февраля февраля февраля февраля февраля февраля февраля февраля февраля февраля февраля февраля февраля февраля февраля февраля февраля февраля февраля февраля февраля февраля февраля февраля февраля февраля февраля февраля февраля февраля февраля февраля февраля февраля февраля февраля февраля февраля февраля февраля февраля февраля февраля февраля февраля февраля февраля февраля февраля февраля февраля февраля февраля февраля февраля февраля февраля февраля февраля февраля февраля февраля февраля февраль февраль февраль февраль февраль февраль февраль февраль февраль февраль февраль февраль февраль февраль февраль февраль февраль февраль февраль февраль февраль февраль февраль февраль февраль февраль февраль февраль февраль февраль февраль февраль февраль февраль февраль февраль февраля
март  :  март март марта март март март март март март март март март март март март март март март март март март март март март март март март март март март март март март март март март март март март
апрель  :  апрель апрель апрель апрель апрель апрель апрель апрель апрель апрель апрель апрель апрель апрель апрель апрель апрель апрель апрель апрель апрель апрель апрель апрель апрель апрель апрель апрель апрель апрель апрель апрель апрель апрель апрель апрель апрель
май  :  май май май май май май май май май май май май май май май май май май май май май май май май май май май май май май май май май май май май май май май
июнь  :  июнь июнь июнь июнь июнь июнь июнь июнь июнь июнь июнь июнь июнь июнь июнь июнь июнь июнь июнь июнь июнь июнь июнь июнь июнь июнь июнь июнь июнь июнь июнь июнь июнь июнь июнь июнь июнь
июль  :  июль июль июль июль июль июль июль июль июль июль июль июль июль июль июль июль июль июль июль июль июль июль июль июль июль июль июль июль июль июль июль июль июль июль июль июль июль
август  :  август август август август август август август август август август август август август август август август август август август август август август август август август август август август август август август август август август август август август
сентябрь  :  сентябрь сентябрь сентябрь сентябрь сентябрь сентябрь сентябрь сентябрь сентябрь сентябрь сентябрь сентябрь сентябрь сентябрь сентябрь сентябрь сентябрь сентябрь сентябрь сентябрь сентябрь сентябрь сентябрь сентябрь сентябрь сентябрь сентябрь сентябрь сентябрь сентябрь сентябрь сентябрь сентябрь сентябрь сентябрь сентябрь сентябрь
октябрь  :  октябрь октябрь октябрь октябрь октябрь октябрь октябрь октябрь октябрь октябрь октябрь октябрь октябрь октябрь октябрь октябрь октябрь октябрь октябрь октябрь октябрь октябрь октябрь октябрь октябрь октябрь октябрь октябрь октябрь октябрь октябрь октябрь октябрь октябрь октябрь октябрь октябрь
ноябрь  :  ноябрь ноября ноября ноября ноября ноября ноября ноября ноября ноябрь ноябрь ноябрь ноябрь ноябрь ноябрь ноябрь ноябрь ноябрь ноябрь ноябрь ноябрь ноябрь ноябрь ноябрь ноябрь ноябрь ноябрь ноябрь ноябрь ноябрь ноябрь ноябрь ноябрь ноябрь ноябрь ноябрь ноябрь ноябрь ноябрь ноябрь ноябрь ноябрь ноябрь ноябрь ноябрь
декабрь  :  декабрь декабрь декабрь декабрь декабрь декабрь декабрь декабрь декабрь декабрь декабрь декабрь декабрь декабрь декабрь декабрь декабрь декабрь декабрь декабрь декабрь декабрь декабрь декабрь декабрь декабрь декабрь декабрь декабрь декабрь декабрь декабрь декабрь декабрь декабрь декабрь декабрь
текущие_событие  :  текущие_события текущие_события текущие_события текущие_события
алфавит  :  алфавиту алфавиту алфавиту
содержание  :  содержание содержание содержание содержание
русский  :  русский русской русский
материал  :  материал
свободный  :  свободной
энциклопедия  :  энциклопедии
страница  :  страницы страницы страницы страница страница страница страница страница странице страницы странице страница страницы страницы страницы страницы страница страница страница страница страница страница страница страница страница страница страница страница страница страница страница страница страница страница страница страницы страница страницы страницы странице страницу страницу страница страницу страниц страницы страниц страницах страница страниц страницы страницы странице странице страницу страницы страница
требовать  :  требуют
проверка  :  проверки
отпатрулировать  :  отпатрулированная отпатрулированная
версия  :  версия версия версия версия версия версия версия версию версия версия версия
подробность  :  подробности
это  :  это это это это
патрулирование  :  патрулирование
стабильный  :  стабильная
перейти  :  перейти перейти перейти перейти перейти перейти перейти перейти
навигация  :  навигации навигация навигация
поиск  :  поиску поиск
сейчас  :  сейчас
время  :  время время время
всемирный  :  всемирное
координировать  :  координированное
дата  :  дата дату дату дата дата дата дата дата дата дата дата дата дата дата дата дата дата дата дата дата дата дата дата дата дата дата дата дата дата дата дата дата дата дата дата дата дата
год  :  год года год год год год год года года года года года года года года году года год года году года году года года года года году года года года года год года года года года года года года года года года года года год года года года года года года года года года года года года год года года года года года года года года года года года года год года года года года года года года года года года года года год года года года года года года года года года года года года год года года года года года года года года года года года года год года года года года года года года года года года года года год года года года года года года года года года года года года год года года года года года года года года года года года года год года года года года года года года года года года года года год года года года года года года года года года года года года год года года года года года года года года года года года года год года года года года года года года года года года года года год года года года года года года года года года года года года год года года года года года года года года года года года года год года года года года года года года года года года года года год года года года года года года года года года года года года год года года года года года года года года года года года года
служебный  :  служебная служебная служебная служебная служебная служебных служебные
обновить  :  обновить
кэш  :  кэш
календарь  :  календарь
месяц  :  месяц месяцев месяцев месяца месяца месяцев месяцам месяцам месяцам месяцам
понедельник  :  понедельник
пн  :  пн
вторник  :  вторник
вт  :  вт
среда  :  среда
сравнить  :  ср
четверг  :  четверг
чт  :  чт
пятница  :  пятница
пт  :  пт
суббота  :  суббота
сб  :  сб
воскресение  :  воскресенье
вс  :  вс
тема  :  темах темы
наука  :  науке наука
технология  :  технологии
спорт  :  спорте спорт спорта спорта спорт спорт спорт спорта спорта спорт спорта спорт спорта спорта спорт спорту спорту спорту спорт спорта спорту
музыка  :  музыке музыка
кино  :  кино кино
викиновость  :  викиновости викиновости викиновости викиновости викиновости викиновости викиновости викиновостях викиновости
полтавский  :  полтавская полтавская
область  :  область область области области областей области области
получить  :  получила получила получила получил получили получили
семь  :  семи семи семь семь
тысяча  :  тысяч тысяч тысяч тысяч тысяч
доза  :  доз доз
вакцина  :  вакцины вакцины
грипп  :  гриппа гриппа
выйти  :  вышел вышел вышел вышла вышел выйти выйти вышла
дистрибутив  :  дистрибутив дистрибутив
ожидать  :  ожидаемые ожидаемые ожидаемые ожидаемые ожидаемые ожидаемые ожидаемые ожидаемые
районный  :  районный районный
суд  :  суд суд суд суда суд
заблокировать  :  заблокировал заблокировал
статья  :  статью статью статьи статьи статьи статьи статьи статьи статьями статьи статья статьи статье статьи
мобилизация  :  мобилизации мобилизации
буля  :  були були
представить  :  представили представили
кубический  :  кубический кубический
максисингл  :  максисингл максисингл
маршак  :  маршак маршак
чуковский  :  чуковский чуковский
агата  :  агата агата
кристи  :  кристи кристи
девять  :  девять девять
подряд  :  подряд подряд
екатеринбург  :  екатеринбурге екатеринбурге
проводить  :  проводят проводят
стратегию6  :  стратегию6 стратегию6
музыкант  :  музыканты музыканты
построить  :  построили построили
творческий  :  творческий творческий
мост  :  мост мост
москва  :  москвой москвой москва москва москве
нижний  :  нижним нижним
новгород  :  новгородом новгородом
умереть  :  умер умер
основатель  :  основатель основатель
группа  :  группы группы
ласковый  :  ласковый ласковый
сергей  :  сергей сергей
борисович  :  борисович борисович
кузнецов  :  кузнецов кузнецов
наса  :  наса наса
озвучить  :  озвучило озвучило
следующий  :  следующей следующей
попытка  :  попытки попытки попытки
запуск  :  запуска запуска
шаблон  :  шаблон шаблона шаблона шаблона шаблон шаблон шаблона шаблона шаблона шаблон шаблон шаблона шаблона шаблона шаблону шаблону шаблон шаблон шаблон шаблон шаблон шаблон
актуальный  :  актуальные актуальные актуальные актуальные актуальныя
просмотр  :  просмотр просмотр просмотр просмотр просмотр просмотр просмотр просмотр просмотры просмотр
обсуждение  :  обсуждение обсуждение обсуждение обсуждение обсуждение обсуждение обсуждение обсуждение обсуждение обсуждение обсуждение обсуждение обсуждений обсуждение обсуждение обсуждение
править  :  править править править править править править править править править
список  :  список список список список список список список список список список список
умерший  :  умерших умершие умерших умерших умерших умерших умершие умерших умершие
недавно  :  недавно недавно недавно недавно недавно недавно недавно
абдрашит  :  абдрашитов абдрашитов
вадим  :  вадим вадим
юсупович  :  юсупович юсупович
альсалем  :  альсалем альсалем альсалем
юсеф  :  юсеф юсеф юсеф
отсутствовать  :  отсутствует отсутствует отсутствует отсутствует отсутствует отсутствует отсутствует отсутствует отсутствует отсутствует отсутствует отсутствует отсутствует отсутствует отсутствует отсутствует отсутствует отсутствует отсутствует отсутствует отсутствует отсутствует
английский  :  английском английском английском английской английской английской английском английский
язык  :  языке языке языке языке языке языке языке языке языке языке языке языке языке языке языке языке языке языке языке языке языке языке языке языке языке языке языке языке языке языке языке языке языке языке языке языке языке языке языке языка языках
баутист  :  баутиста баутиста баутиста
луалхатить  :  луалхати луалхати луалхати
жирмунский  :  жирмунская жирмунская
тамара  :  тамара тамара
александрович  :  александровна александровна
кузьмин  :  кузьмин кузьмин
евгений  :  евгений евгений
иванович  :  иванович иванович иванович иванович
мендес  :  мендес мендес мендес
амазонино  :  амазонино амазонино амазонино
португальский  :  португальском португальский
трехолт  :  трехолт трехолт трехолт
арне  :  арне арне арне
норвежский  :  норвежском норвежском
хашим  :  хашим хашим хашим
надя  :  надя надя надя
алёшин  :  алёшин алёшин
николай  :  николай николай
павлович  :  павлович павлович
байкал  :  байкал байкал
дениз  :  дениз дениз
григорьев  :  григорьев григорьев
анатолий  :  анатолий анатолий
физиолог  :  физиолог
другой  :  другие других
ссылка  :  ссылки ссылки ссылка ссылка ссылка ссылки ссылки
категория  :  категория категория категория категории категории категория категория
категория2023  :  категория2023
медиафайл  :  медиафайлы
относиться  :  относящиеся
проект  :  проект проект проект проект проект проект проекта проекте
переводызапрос  :  переводызапросы
перевод  :  перевод перевод
запрос  :  запросы запросы
стать  :  статей статей стал стал стал стала стал стала стали стал стали стали статей
к  :  к
создание  :  созданию создание
викикурьер  :  викикурьер викикурьер
история  :  история история истории истории истории истории истории история
русскоязычный  :  русскоязычного
раздел  :  раздела
прессрелиз  :  прессрелизы прессрелизы
планета  :  планета
викимедиа  :  викимедиа
главный  :  главные главный
заглавный  :  заглавной заглавной заглавной заглавная заглавную заглавную заглавная
текущие_события_на_заглавной_страница  :  текущие_события_на_заглавной_странице
правка  :  правка правка правка правок правки правки
страницекандидат  :  страницекандидаты
кандидат  :  кандидаты
предложить  :  предложить
добавить  :  добавить добавить добавить
блокада  :  блокада блокада
нагорный  :  нагорного нагорного
карабах  :  карабаха карабаха
вторжение  :  вторжение вторжение вторжение вторжения
россия  :  россии россии россии россии россии россии россии россии россии россия
украина  :  украину украину украину украину украине
протест  :  протесты протесты протеста
перу  :  перу перу
чемпионат  :  чемпионаты чемпионат чемпионат чемпионат чемпионате чемпионате чемпионат чемпионат чемпионате чемпионат чемпионат чемпионат чемпионате чемпионат чемпионат чемпионата чемпионат чемпионат чемпионат чемпионат чемпионат чемпионате чемпионат чемпионат чемпионат чемпионат чемпионат чемпионат чемпионате чемпионат чемпионат чемпионат чемпионат чемпионат чемпионат чемпионата
мир  :  мира мира мира мире мира мира мира мира мира мира мира мира мира мира мира мира мира мира мира мира мира мира мира мира мира мира мира мира мира мира мира мира мира мира мира мир мира мира мире
лыжный  :  лыжным лыжные лыжным лыжным лыжному лыжную лыжным лыжным лыжным лыжные лыжным лыжный
вид  :  видам виды видам видам видам видам видам
фристайл  :  фристайлу фристайл фристайлу фристайлу фристайлу фристайлу фристайлу фристайлу фристайлу
сноуборд  :  сноуборду сноуборд сноуборду сноуборду сноуборду сноуборду сноуборду
кейт  :  кейт кейт кейт кейт
бланшетта  :  бланшетт бланшетт бланшетт бланшетт
по  :  по
малый  :  меньшей меньшей
мера  :  мере меры мере
человек  :  человека человек человек людей человек человек человек человека человек человек человек человек человек человек человек человек человек человек человек человек человек
погибнуть  :  погибли погибло погибли погибли погиб погибли погиб погибли погибло погиб погибло погибших погиб погибли погибших
результат  :  результате результате результате результате результате результате результате результате результат результате результате результате результате
крушение  :  крушение крушения крушение крушения крушение крушения
лодка  :  лодки лодки лодки
мигрант  :  мигрантами мигрантами мигрантами мигрантов
калабрия  :  калабрии
затопление  :  затопления
италия  :  италия италии италия италии италия италии италии
приз  :  приз приз
берлинский  :  берлинский берлинского берлинский берлинскому
международный  :  международный международного международная международная
кинофестиваль  :  кинофестиваль кинофестиваля
присудить  :  присуждён
картина  :  картине картина картина
французский  :  французского французская французский
режиссёр  :  режиссёра
филибер  :  филибер филибера
николя  :  николя николя
на  :  на на на на на на на на на на на
адамант  :  адаманте адаманте
премия  :  премия премия премии премия премия премия премия премии премия премий
серебряный  :  серебряный серебряным
медведь  :  медведь медведем
хороший  :  лучшую лучшую лучший лучший лучшую лучшую лучшую лучшую лучшую лучшую лучший лучшим лучшему лучшие лучшими
режиссура  :  режиссуру режиссуру режиссуру режиссуру
отметить  :  отмечен
фильм  :  фильм фильм фильм фильм фильм фильм фильм фильм фильме фильм фильме
гаррель  :  гаррель гарреля
филипп  :  филипп филиппа
больший  :  большая большая
колесница  :  колесница колесница
в  :  в в в в в в в в в в в в в в в в в в в в в в в в в в во в в в в в в в в в в в
землетрясение  :  землетрясение землетрясения землетрясение землетрясение землетрясения землетрясений землетрясение землетрясения землетрясение землетрясений землетрясений землетрясений
турция  :  турции турция турции турции турция турции турции турции турции турции
сирия  :  сирии сирия сирии сирия сирии сирии
сам  :  самого самой
разрушительный  :  разрушительного
серия  :  серии серии серии серии
афтершок  :  афтершок афтершоков
территория  :  территории территории
провинция  :  провинциях
ввести  :  введено
чрезвычайный  :  чрезвычайное
положение  :  положение
срок  :  сроком
церемония  :  церемонии церемония церемония
вручение  :  вручения вручения
награда  :  награды наград наград награды
западный  :  западном западном западном западном
фронт  :  фронте фронте фронте
перемена  :  перемен перемен
бергер  :  бергер бергера
эдвард  :  эдвард эдварда
мужской  :  мужскую мужскую
роль  :  роль роль роль
батлер  :  батлер батлер
остин  :  остин остин
элвис  :  элвис элвис
женский  :  женскую женскую
тара  :  тар тар
илл  :  илл
документальный  :  документальный
удостоиться  :  удостоилась
навальный  :  навальный навальный
норвежец  :  норвежец норвежец норвежец норвежцы норвежец норвежца
бё  :  бё бё бё бё
йоханнес  :  йоханнес йоханнес йоханнес йоханнес йоханнес
тиннеса  :  тиннес тиннес тиннес тиннес
первый  :  первым первого первым первое первом первую
мужчина  :  мужчиной мужчин
завоевать  :  завоевавшим завоевал завоевала
медаль  :  медалей медалям медали медаль
один  :  одном одной
биатлон  :  биатлону биатлону биатлону биатлону
эссухна  :  эссухне эссухне эссухне
нападение  :  нападение нападения
боевик  :  боевиков
исламский  :  исламское исламского
государство  :  государство государства
каждый  :  каждый
размещать  :  размещать
свой  :  свои своем своё
новость  :  новости новость новости новостей новостей новости новости новости новости
фоторепортаж  :  фоторепортажи
интервью  :  интервью
присоединяться  :  присоединяйся
мы  :  нам мы нами
последний  :  последние последних последние последний
событияпоследний  :  событияпоследние событияпоследние
текущие_событияпоследние_событие  :  текущие_событияпоследние_события текущие_событияпоследние_события текущие_событияпоследние_события
запись  :  запись запись запись
любой  :  любой
желать  :  желающий
прочитать  :  прочитайте
внести  :  внесите
наиболее  :  наиболее
значимый  :  значимые
указать  :  указав
источникссылка  :  источникссылку
см_такж  :  см_также
смотреть  :  см см см
также  :  также также также
лента  :  лента лента
месси  :  месси месси месси
лионель  :  лионель лионель
признать  :  признан признал
фифа  :  фифа фифа фифа
футбол  :  футбол футболу
футболист  :  футболистом футболисту
иран  :  иран иран иране иране
иранский  :  иранские иранским
разведка  :  разведка
месторождение  :  месторождений месторождения месторождение
полезный  :  полезных
ископаемое  :  ископаемых
геологоразведчик  :  геологоразведчики
сообщить  :  сообщили сообщило сообщить сообщить
обнаружение  :  обнаружении
страна  :  стране страны страны
литий  :  литий лития лития
хорватия  :  хорватия хорватию хорватии
обрушиться  :  обрушился
снегопад  :  снегопад снегопада
изз  :  изза изза изза изза изза изза изза изза
который  :  которого которые которого которая которого котором который которые
трасса  :  трассах
оказаться  :  оказалось
занести  :  занесено
несколько  :  несколько несколько
сотня  :  сотен
автомобиль  :  автомобилей
город  :  городах городах городах городе городе город
грачац  :  грачац грачац
обровац  :  обровац обровац
госпич  :  госпич госпич
книна  :  книн книн
организовать  :  организованы
центр  :  центры
размещение  :  размещения
буря  :  бури бури
иметь  :  имеют имеющей
возможность  :  возможности возможностей
добраться  :  добраться
нужный  :  нужных
место  :  мест место
венгрия  :  венгрия
венгерский  :  венгерская венгерский
авиакомпания  :  авиакомпания
объявить  :  объявила объявлен объявили объявлен
решение  :  решении решение
приостановить  :  приостановить приостановит приостановит
рейс  :  рейсы рейсы
кишинёв  :  кишинёв кишинёв кишинев
соображение  :  соображениям соображений
безопасность  :  безопасности безопасности безопасности безопасности
испания  :  испания испании испании
курортный  :  курортном
остров  :  острове острове
майорк  :  майорка майорка майорка
шторм  :  шторма
джульеттa  :  джульеттa
красный  :  красный красный
уровень  :  уровень уровень уровня
погодный  :  погодной погодной
опасность  :  опасности опасности
выпалить  :  выпали
сугроб  :  сугробы
высота  :  высотой
полметра  :  полуметра
ожидаться  :  ожидается
продолжение  :  продолжение
свыше  :  свыше
нелегальный  :  нелегальными
борт  :  борту борту борту борту
около  :  около
финал  :  финал финал финала финала финале финале финала финала финала финала финала финала
кубок  :  кубка кубка кубка кубка кубок кубок
футбольный  :  футбольной футбольной футбольный футбольный
лига  :  лиги лиги лига лиги лига лиге лига лиги лигу лига лига лиги лига лигу лиги лиги лиги лиги лиги лиги лиги лигу
манчестер  :  манчестер манчестер манчестер манчестер манчестер манчестер манчестер
юнайтед  :  юнайтед юнайтед юнайтед юнайтед юнайтед юнайтед юнайтед юнайтед юнайтед
обыграть  :  обыграл обыграл обыграли обыграли обыграл обыграл обыграл обыграла
уэмбль  :  уэмбли
ньюкасл  :  ньюкасл ньюкасл
счёт  :  счётом счётом счётом счётом счётом счётом счётом
победный  :  победный
мяч  :  мяч мячей
забить  :  забил забили
каземиро  :  каземиро каземиро
шведка  :  шведка
андерссон  :  андерссон андерссон андерссон
эбба  :  эбба эбба эбба
выиграть  :  выиграла выиграв выиграла выиграл выигравшим выиграла выиграл выиграл выиграла выиграл выиграла выиграли
скиатлоно  :  скиатлон скиатлоне скиатлон скиатлон
планица  :  планице планице планица планице
канадец  :  канадец
кингсбрать  :  кингсбери кингсбери кингсбери
микаэль  :  микаэль микаэль
чемпион  :  чемпионом чемпионом чемпионов чемпионов чемпионов чемпионов чемпионов чемпионами чемпионов чемпионов
могул  :  могул могуле могуле
бакуриани  :  бакуриани бакуриани бакуриани бакуриани бакуриани
фристайлистка  :  фристайлистка
лаффон  :  лаффон лаффон лаффон
перрина  :  перрин перрин
золото  :  золото золото
российский  :  российский российского российской российской
теннисист  :  теннисист
медведев  :  медведев медведев медведев
даниил  :  даниил даниил
сергеевич  :  сергеевич
турнир  :  турнир турнире турнира турнира
открытый  :  открытый
катар  :  катара катар катар
теннис  :  теннису
среди  :  среди
доха  :  дохе дохе
день  :  день
годовщина  :  годовщины годовщину
начало  :  начала
предприниматься  :  предпринимались
проведение  :  проведения
антивоенный  :  антивоенных
акция  :  акций акции
возлагаться  :  возлагались
цветок  :  цветы цветы цветы цветы
памятник  :  памятникам памятник памятнику
пройти  :  прошли прошёл прошёл прошёл прошёл прошла прошёл прошли
пикет  :  пикеты пикеты
москвич  :  москвичи
возлагать  :  возлагали
леса  :  лесе
украинка  :  украинке украинки
леся  :  леси
задержать  :  задержано задержано
менее  :  менее менее менее
коммунальный  :  коммунальная
служба  :  служба служб службы
убирать  :  убирала
весь  :  всего
с  :  с
космодром  :  космодрома космодрома космодром
байконур  :  байконур байконур
космический  :  космическая
станция  :  станция
мкс  :  мкс мкс
стартовать  :  стартовала стартовала
ракетаноситель  :  ракетаноситель ракетаноситель
союз21  :  союз21а союз21а союз21а
беспилотный  :  беспилотным
корабль  :  кораблём корабль корабля
союз  :  союз союз союз союз союзу
мс23  :  мс23 мс23
заменить  :  заменить
повреждëнный  :  повреждëнный
метеорит  :  метеоритом
мс22  :  мс22 мс22 мс22
китай  :  китай китае китай китае китае
успешный  :  успешный
пуск  :  пуск
спутник  :  спутника спутник
хорус1  :  хорус1
помощь  :  помощи
ракета  :  ракеты
чанчжэн2c  :  чанчжэн2c
цзюцюань  :  цзюцюань цзюцюань
болдуин  :  болдуин болдуину болдуину
алек  :  алек
алеку  :  алеку алеку
официально  :  официально
разрешить  :  разрешил разрешил
продолжить  :  продолжить
работа  :  работу работ
ржавчина  :  ржавчина ржавчина
съёмочный  :  съёмочной
площадка  :  площадке
непреднамеренный  :  непреднамеренно
убить  :  убил
оператор  :  оператора
нба  :  нба нба нба нба нба нба
сыгранный  :  сыгран
второй  :  второй втором второй
результативность  :  результативности
матч  :  матч матче матча матче матч матч матче матче матче
сакраменто  :  сакраменто сакраменто сакраменто
кингз  :  кингз кингз
победить  :  победили победив победив победив
овертайм  :  овертайме овертайме овертайме
лосанджелес  :  лосанджелес лосанджелес
клипперс  :  клипперс клипперс клипперс
крюгер  :  крюгер крюгер крюгер
симя  :  симен симен
хегстадо  :  хегстад хегстад
впервые  :  впервые впервые впервые впервые впервые впервые впервые впервые впервые
гонка  :  гонкам гонки гонке
вестволл  :  вестволл вестволл
хансный  :  хансен хансен хансен
гюд  :  гюда гюда
чемпионка  :  чемпионкой чемпионкой
двоеборье  :  двоеборью двоеборье
определиться  :  определились
участник  :  участники участников участники участника участников
плейофф  :  плейофф плейофф плейофф плейофф плейофф плейофф плейофф плейофф плейофф плейофф плейофф
гагарин  :  гагарина
кхл  :  кхл кхл кхл
сезон  :  сезоне сезона сезоне
восточный  :  восточной восточной
конференция  :  конференции конференции
могила  :  могила
поздний  :  позднего
бронзовый  :  бронзовый бронзового
век  :  век века
обнаружить  :  обнаруженная обнаружить обнаружено
археология  :  археология
археологический  :  археологических
раскопка  :  раскопках
мегиддый  :  мегиддо
мегидо  :  мегидо
израиль  :  израиль израиль израиль израиля израиля израиля израиле израиле израиля
позволить  :  позволила
исследователь  :  исследователям
редкий  :  редкий
пример  :  пример
деликатный  :  деликатной
черепной  :  черепной
хирургия  :  хирургии
ранний  :  ранней раннее
род  :  роде
ближний  :  ближнем
восток  :  востоке
потерпеть  :  потерпел потерпел
вертолёт  :  вертолёт вертолёт вертолет
находиться  :  находились находилось находится
министр  :  министр министр министром
зам  :  замы
крупный  :  крупнейшем крупных крупнейшем
нефтехранилище  :  нефтехранилище нефтехранилище нефтехранилище
мексика  :  мексика мексики мексики
произойти  :  произошёл произошло произошло произошли произошедших произошло произошедших
пожар  :  пожар пожар пожаре пожар пожаре
таджикистан  :  таджикистан таджикистане таджикистане
сила  :  силой силы силу силы силы силу
балл  :  балла балла
белгородский  :  белгородской белгородской
разбиться  :  разбился
штурмовик  :  штурмовик
су25  :  су25 су25
военновоздушный  :  военновоздушные военновоздушные военновоздушные
федерация  :  федерации федерации
ввс  :  ввс
рф  :  рф рф
пилот  :  пилот пилот
оман  :  оман оман оман
открыть  :  открыл открыли открыл
воздушный  :  воздушное
пространство  :  пространство пространства
израильский  :  израильских израильских
самолёт  :  самолётов самолета
иностранный  :  иностранных
дело  :  дел дел
коэн  :  коэн коэн
эли  :  эли эли
политик  :  политик
назвать  :  назвал
исторический  :  историческим историческая
барселона  :  барселона барселону барселону барселону
клуб  :  клуб клуб клуб клубе клуб клуб клубе
официальный  :  официальном официальном
ювентус  :  ювентус ювентус ювентусу
европа  :  европы европы европы европы европы европы европу европы европы европы европы европы европы
уефа  :  уефа уефа уефа уефа уефа уефа уефа уефа уефа уефа
ди  :  ди ди ди
мария  :  мария мария марии
анхель  :  анхель анхель
сделать  :  сделал сделанных
хеттрик  :  хеттрик хеттрик
ворота  :  ворота ворота
нант  :  нанта
унион  :  унион унион униону
выступать  :  выступающий
обладатель  :  обладателя обладателем
аякс  :  аякс аякс аякс
амстердам  :  амстердам
амстердамский  :  амстердамский
байер  :  байер байер байеру
монако  :  монако монако
друг  :  друг друга
обменяться  :  обменявшись
гостев  :  гостевыми
победа  :  победами побед
раунд  :  раунде
далёкий  :  дальше
пенальти  :  пенальти пенальти
испанский  :  испанская испанский
севилья  :  севилья севилья
рекордный  :  рекордные рекордные
выигрывать  :  выигрывавшая
псв  :  псв псв
нхл  :  нхл нхл
баффало  :  баффало баффало
сейбрзнуть  :  сейбрз сейбрз
драматичный  :  драматичном
тампабэя  :  тампабэй
лайтнинга  :  лайтнинг лайтнинг
тампубэя  :  тампубэй
эдмонтон  :  эдмонтон эдмонтон эдмонтон
ойлёрзнуть  :  ойлерз ойлерз
разгромить  :  разгромили разгромил разгромил разгромил
гость  :  гостях гостях
питтсбург  :  питтсбург питтсбург питтсбург
пингвинза  :  пингвинз пингвинз
бостон  :  бостон бостон
селтикс  :  селтикс селтикс селтикс
индиана  :  индиану
пейсерс  :  пейсерс пейсерс пейсерс
центровой  :  центровой
майлз  :  майлз
тёрнер  :  тёрнер
набрать  :  набрал набрали набрал
очко  :  очков очко очков
рот  :  рот рот
ноэ  :  ноэ ноэ
швейцарец  :  швейцарцем швейцарцы
акробатика  :  акробатику
немка  :  немка немка
альтхаус  :  альтхаус альтхаус альтхаус
катарин  :  катарина катарина
прыжок  :  прыжкам прыжках
нормальный  :  нормального нормального
трамплин  :  трамплина трамплина
рейд  :  рейда рейда
военный  :  военных военного военных
полиция  :  полиции
наблус  :  наблус наблус наблусе
берег  :  берегу берегов берегов
иордан  :  иордана
палестинец  :  палестинцев
вмещать  :  вмещающем
тыс  :  тыс тыс
зритель  :  зрителей
стадион  :  стадионе стадион
лужники  :  лужники лужники лужниках лужниках
политический  :  политический
митинг  :  митинг митинг
концерт  :  концерт концерт
выступить  :  выступил
путин  :  путин путин путин путин путин путин
владимир  :  владимир владимир владимир владимир
владимирович  :  владимирович
данные  :  данным данных
министерство  :  министерство
внутренний  :  внутренних
мвд  :  мвд мвд
количество  :  количество количеству
превысить  :  превысило
обрушение  :  обрушение обрушении
грунт  :  грунта
карьера  :  карьере карьере
угледобывающий  :  угледобывающего
предприятие  :  предприятия
момент  :  момент
происшествие  :  происшествия
работать  :  работали
числиться  :  числятся
пропасть  :  пропавшими пропали
вести  :  вести вести
продолжаться  :  продолжающейся
засуха  :  засухи
венеция  :  венеция венеции венеции
пересохнуть  :  пересохли пересохли
городской  :  городские
канал  :  каналы каналы
часть  :  части части
мочь  :  могут можете могут
передвигаться  :  передвигаться
гондола  :  гондола гондолы
экстренный  :  экстренных
небраска  :  небраска небраске
поезд  :  поезда поезд
рельс  :  рельсов рельсов
сойти  :  сошли сошёл
вагон  :  вагонов вагоном
уголь  :  углём угля
новый  :  новых новой новые
магнитуда  :  магнитуда магнитудой
составить  :  составила
разница  :  разница
толчок  :  толчками
минута  :  минут минуте
ранение  :  ранения ранения
остановить  :  остановил остановили
действие  :  действие
указ  :  указа указ
давность  :  давности
касаться  :  касающегося
внешний  :  внешней
политика  :  политики политика
послание  :  послание
президент  :  президента президент президентов
федеральный  :  федеральному
собрание  :  собранию
заявить  :  заявил заявил
приостановка  :  приостановке
участие  :  участия участии участие участие
договор  :  договоре договоре
снвiii  :  снвiii снвiii
вступить  :  вступившим
у  :  у у
новороссийск  :  новороссийск новороссийска
чёрный  :  чёрном черном
море  :  море море
переломиться  :  переломился переломилось
пополам  :  пополам пополам
затонуть  :  затонул
сухогруз  :  сухогруз
флаг  :  флагом
коморы  :  коморы комор
везти  :  вез
мраморный  :  мраморную
крошка  :  крошку
турецкий  :  турецких
порт  :  портов
член  :  членов
экипаж  :  экипажа
реал  :  реал реал
мадрид  :  мадрид
ливерпуль  :  ливерпуль ливерпуль
уступать  :  уступая
словенский  :  словенской словенский
открытие  :  открытия
столица  :  столице
объединить  :  объединённые
арабский  :  арабские арабский
эмират  :  эмираты
оаэ  :  оаэ
абудаби  :  абудаби абудаби абудаби
открыться  :  открылась открылась
юбилейный  :  юбилейная
выставка  :  выставка выставка
вооружение  :  вооружений вооружениях вооружений
эрдоган  :  эрдоган эрдоган
реджеп  :  реджеп реджеп
тайип  :  тайип
ход  :  ходе
спасательный  :  спасательных
спасти  :  спасено спасли
разрушить  :  разрушено
млн  :  млн
здание  :  зданий
военнослужащий  :  военнослужащих
срочный  :  срочной
блиндаж  :  блиндаже блиндаже
курский  :  курской курской
причина  :  причиной
нарушение  :  нарушение
правило  :  правил
лондон  :  лондон лондоне
состояться  :  состоялась состоялся
стихийный  :  стихийные
бедствие  :  бедствия
бразильский  :  бразильском
санпаула  :  санпаулу санпаулу
штат  :  штат штате штат
ливень  :  ливней ливней
оползень  :  оползней оползней
солтлейксити  :  солтлейксити солтлейксити
звезда  :  звёзд звёзд звезд
немецкий  :  немецком
оберхоф  :  оберхоф оберхофе
завершиться  :  завершился завершился
золотой  :  золотых золотым золотой золотую
франция  :  франции
горнолыжный  :  горнолыжному горнолыжному горнолыжному горнолыжному
лидер  :  лидерами
общий  :  общему
сборная  :  сборная
австрия  :  австрии
грузинский  :  грузинском грузинский
начаться  :  начался начался
конфликт  :  конфликты
преступление  :  преступления
перестрелка  :  перестрелке
ночной  :  ночной ночном
мемфис  :  мемфис мемфис
теннесси  :  теннесси теннесси теннесси
пострадать  :  пострадали пострадали пострадали пострадала
число  :  числе число число
атаковать  :  атаковали
дамаск  :  дамаск дамаск дамаска
ещё  :  ещё ещё
несудоходный  :  несудоходный
район  :  район
южный  :  южной
тихий  :  тихого
океан  :  океана
упасть  :  упали упала
несгораемый  :  несгораемые
обломок  :  обломки
разгерметизировать  :  разгерметизированного
грузовой  :  грузового
прогресс  :  прогресс прогресс
мс21  :  мс21 мс21
финский  :  финский финский
хоккейный  :  хоккейный хоккейная хоккейный
таппара  :  таппара таппара таппары
шведский  :  шведский шведский
лулео  :  лулео лулео
австралийский  :  австралийском
батёрстый  :  батерст
австралия  :  австралия
батерст  :  батерсте
легкоатлетический  :  легкоатлетическому легкоатлетическому
кросс  :  кроссу кроссу кроссу
всё  :  все
шесть  :  шесть
кыргызстан  :  кыргызстана
пятеро  :  пятеро
бывший  :  бывших
действовать  :  действующий действовать
встретиться  :  встретились
нейтральный  :  нейтральной
примечание  :  примечания примечания примечания
снежный  :  снежной
парализовать  :  парализовано
движение  :  движение
ряд  :  ряде
вырасти  :  выросло выросло
шестой  :  шестой
неопределённый  :  неопределённом неопределённом неопределённом неопределённом неопределённом неопределённом неопределённом неопределённом неопределённом неопределённом неопределённом неопределённом неопределённом неопределённом неопределённом неопределённом неопределённом неопределённом неопределённом неопределённом неопределённом неопределённом неопределённом неопределённом неопределённом неопределённом неопределённом неопределённом неопределённом неопределённом неопределённом неопределённом
неопр  :  неопр неопр неопр неопр неопр неопр неопр неопр неопр неопр неопр неопр неопр неопр неопр неопр неопр неопр неопр неопр неопр неопр неопр неопр неопр неопр неопр неопр неопр неопр неопр неопр
обращение  :  обращения обращения обращения обращения обращения обращения обращения обращения обращения обращения обращения обращения обращения обращения обращения обращения обращения обращения обращения обращения обращения обращения обращения обращения обращения обращения обращения обращения обращения обращения обращения обращения обращения обращения
видео  :  видео
фристайлист  :  фристайлисты
маррей  :  маррея
задержание  :  задержания
одиночный  :  одиночные
как  :  как как
война  :  войны
бибиси  :  бибиси
замена  :  замену
повредить  :  повреждённому
кнр  :  кнр
вывести  :  вывела
орбита  :  орбиту
дистанционный  :  дистанционного
зондирование  :  зондирования
сниматься  :  сниматься
запретить  :  запретил
употреблять  :  употреблять
алкоголь  :  алкоголь
сумма  :  сумме
норв  :  норв
спортэкспресс  :  спортэкспресс спортэкспресс спортэкспресс
гид  :  гида
вествольд  :  вествольд
чм  :  чм чм чм
несмотря  :  несмотря
падение  :  падение
известный  :  известны
самый  :  самое
свидетельство  :  свидетельство
операция  :  операции
головной  :  головном
мозг  :  мозге
юг  :  юге
сильный  :  сильный
ведомость  :  ведомости
авиапространство  :  авиапространство
перевозчик  :  перевозчиков
тасс  :  тасс тасс
помочь  :  помог
рспорт  :  рспорт рспорт
вылететь  :  вылетел
уступить  :  уступив
проиграть  :  проиграл проиграла проиграла
смочь  :  смог
выезд  :  выезде
англ  :  англ
малкин  :  малкина
два  :  две
голевой  :  голевые
передача  :  передачи
риа  :  риа риа риа риа
усилить  :  усилены
силовик  :  силовиков
интерфакс  :  интерфакс
митингеконцерт  :  митингеконцерте
при  :  при
низкий  :  низкого
вода  :  воды
сша  :  сша сша сша
что  :  что
известно  :  известно
утратить  :  утратившим
внешнеполитический  :  внешнеполитическом
курс  :  курсе
стратегический  :  стратегических
наступательный  :  наступательных
коммерсантъ  :  коммерсантъ коммерсантъ коммерсантъ
судно  :  судно
россиянин  :  россиян россиян
вы  :  вас вы вы
никто  :  никто
ждать  :  ждёт
удалить  :  удалил
изпод  :  изпод
завал  :  завалов
шестеро  :  шестеро
бразилия  :  бразилии
команда  :  команда команду
яннис  :  янниса
леброн  :  леброна
тэйтум  :  тэйтум
бе  :  бе
всетаки  :  всетаки
поступь  :  поступь
финиш  :  финише финиша
эй  :  эй
джей  :  джей
гиннис  :  гиннис
принести  :  принёс
греция  :  греции
лыжник  :  лыжники
собраться  :  собрались
стрельба  :  стрельбы
цитадель  :  цитадель
удар  :  ударов
хоккеист  :  хоккеисты
эфиопский  :  эфиопская
легкоатлетка  :  легкоатлетка
метр  :  метров
забег  :  забег
события_по_месяц  :  события_по_месяцам события_по_месяцам
источник  :  источник
персональный  :  персональные
инструмент  :  инструменты инструменты
мой  :  моего моего
представиться  :  представились
система  :  системе систему системе
вклад  :  вклад
предлагать  :  предлагаем
создать  :  создать создать созданных создать создать
учётный  :  учётную учётную
войти  :  войти войти
хотя  :  хотя
обязательно  :  обязательно
здесь  :  здесь
зарегистрироваться  :  зарегистрироваться
необязательно  :  необязательно
имя  :  имён
основной  :  основной
изменить  :  изменить
вариант  :  вариант
читать  :  читать
этот  :  эта эта эта
защитить  :  защищена
изменение  :  изменений изменений изменений изменения
посмотреть  :  посмотреть посмотреть
её  :  её
исходный  :  исходный
текст  :  текст текст текст
код  :  кода
журнал  :  журнал
большой  :  больше
искать  :  искать искать искать
найти  :  найти найти
содержать  :  содержащие
указанный  :  указанный
точность  :  точности
такой  :  такое
название  :  название
считаться  :  считающиеся
избранный  :  избранные
случайно  :  случайно
выбрать  :  выбранную
случайный  :  случайная
поддержать  :  поддержите
пожертвовать  :  пожертвовать
ошибка  :  ошибке ошибке
о  :  о
заниматься  :  заниматься
сообщество  :  сообщество
форум  :  форум форум
свежий  :  свежие
расположение  :  расположения
справка  :  справки справка
ссылаться  :  ссылающихся ссылается
данный  :  данную
сюда  :  сюда
связанный  :  связанные связанный
постоянный  :  постоянная постоянная
подробный  :  подробнее подробнее
сведение  :  сведения
элемент  :  элемент элемент
репозиторий  :  репозитория
викидать  :  викиданных
печатьэкспорт  :  печатьэкспорт
книга  :  книгу книгу
коллекция  :  коллекцию
скачать  :  скачать скачать
файл  :  файл
печать  :  печати печати
староанглийский  :  староанглийский
ассамский  :  ассамский
гьанжесло  :  гьанжесел
лъугьабахъинать  :  лъугьабахъинал
аварский  :  аварский
авар  :  авар
азербайджанский  :  азербайджанский
ағымдағ  :  ағымдағы ағымдағы
ваҡиғаларбашвик  :  ваҡиғаларбашвики
наградалар  :  наградалары
башкирский  :  башкирский
башҡортс  :  башҡортса
парталый  :  партал
падзеі  :  падзеі
белорусский  :  белорусский
беларускать  :  беларуская
каталанский  :  каталанский
ковы  :  ков
карара  :  карара
хилларша  :  хилларш
чеченский  :  чеченский
нохчийна  :  нохчийн
себуано  :  себуано
чероки  :  чероки
сорань  :  сорани
чешский  :  чешский
википести  :  википеди википеди
хыпарсем  :  хыпарсем
чувашский  :  чувашский
чӑваидти  :  чӑвашла
датский  :  датский
эве  :  эве
греческий  :  греческий
эсперанто  :  эсперанто
баскский  :  баскский
персидский  :  персидский
фарерский  :  фарерский
ирландский  :  ирландский
ганя  :  гань
гуджарать  :  гуджарати
мэнский  :  мэнский
хакка  :  хакка
хинди  :  хинди
хорватский  :  хорватский
армянский  :  армянский
интерлингва  :  интерлингва
индонезийский  :  индонезийский
исландский  :  исландский
японский  :  японский
оқиғалар  :  оқиғалар
казахский  :  казахский
кхмерский  :  кхмерский
корейский  :  корейский
курдский  :  курдский
латинский  :  латинский
ладиный  :  ладино
люксембургский  :  люксембургский
лимбургский  :  лимбургский
литовский  :  литовский
майтхиль  :  майтхили
минангкабау  :  минангкабау
малаялам  :  малаялам
мэдээнья  :  мэдээний
сан  :  сан
монгольский  :  монгольский
монгол  :  монгол
маратх  :  маратхи
малайский  :  малайский
бирманский  :  бирманский
эрзянский  :  эрзянский
эрзянить  :  эрзянь
мазандеранский  :  мазандеранский
науру  :  науру
неаполитанский  :  неаполитанский
непальский  :  непальский
неварский  :  неварский
ниас  :  ниас
нидерландский  :  нидерландский
окситанский  :  окситанский
нога  :  ног
хабæрттæ  :  хабæрттæ
осетинский  :  осетинский
ирон  :  ирон
панджаби  :  панджаби
пампанга  :  пампанга
польский  :  польский
румынский  :  румынский
сицилийский  :  сицилийский
шотландский  :  шотландский
синдх  :  синдхи
сингальский  :  сингальский
словацкий  :  словацкий
сомали  :  сомали
албанский  :  албанский
догађајь  :  догађаји
сербский  :  сербский
српски  :  српски
сунданский  :  сунданский
тамильский  :  тамильский
рӯйдодҳой  :  рӯйдодҳои
кунунӣ  :  кунунӣ
таджикский  :  таджикский
тоҷикӣ  :  тоҷикӣ
тайский  :  тайский
тагалог  :  тагалог
хәзерг  :  хәзерге
вакыйгалар  :  вакыйгалар
татарский  :  татарский
татарча  :  татарча
поточні  :  поточні
події  :  події
украинский  :  украинский
українська  :  українська
урд  :  урду
узбекский  :  узбекский
вьетнамский  :  вьетнамский
волапюк  :  волапюк
валлонский  :  валлонский
ву  :  ву
идиш  :  идиш
йоруба  :  йоруба
китайский  :  китайский
зулу  :  зулу
межъязыковой  :  межъязыковые
отредактировать  :  отредактирована
доступный  :  доступен
текст_лицензии_creative_commons_attributionsharealike_30_unported  :  текст_лицензии_creative_commons_attributionsharealike_30_unported
лицензия  :  лицензии
отдельный  :  отдельных
случай  :  случаях
дополнительный  :  дополнительные
условие  :  условия условия
использование  :  использования
зарегистрировать  :  зарегистрированный
товарный  :  товарный
знак  :  знак
некоммерческий  :  некоммерческой
организация  :  организации
конфиденциальность  :  конфиденциальности
описание  :  описание
отказ  :  отказ
ответственность  :  ответственности
контакт  :  контакты
связаться  :  свяжитесь
мобильный  :  мобильная
разработчик  :  разработчики
статистика  :  статистика
заявление  :  заявление
кук  :  куки
текущие_событияsidebar  :  текущие_событияsidebar
текущие_событиякалендарь  :  текущие_событиякалендарь
календарь_на_месяц  :  календарь_на_месяц
карточка  :  карточка
список_недавно_умереть  :  список_недавно_умерших
список_недавно_умершихдать  :  список_недавно_умершихданные
